XXXXXXXXXXX
XXXXXXXXXXX
XOOOXXXXXXX
XXFXXXXXOOX
XXOXXXXPOXX
XXOXXXXOOXX
XXOXXXXOOXX
XOOOOOOOOOX
XOOOOOOOOOX
XXXXXXXXXXX