OOOOOOOOOOX
OOOOPOOOOOO
XXXOOOOOOOO
XOOXOOXOOOO
OXOOXXXXXOX
OOXOOOOOOOX
OOOXOOOFOOO
OOOXOOOOOOO
OOOXOXOOOXO
OOOXOXOOOOX