XXXXXXXXXXX
XXXXXXXXXXX
XOOOXOOOOOX
XXFXXXOOOXX
XXOXXXOPOXX
XXOXXXOOOXX
XOOOOOOOOOX
XOOOOOOOOOX
XOOOOOOOOOX
XXXXXXXXXXX