XOOOOOOOOOO
XXXXXXFOOOO
XOOOOOOXXXX
XOXXXXXXOOO
XOXOOOOOOOO
XOXXXXXXOOO
XOOOOOOXOOO
XOXXXXXXXXO
XPOOOOOOOXX
XOXXXXXOOOO