XXXXXOOXXXX
XXXXXPOXXXX
XXXXXOXXXXX
XXXXXOXXXXX
XXXXOOOXXXX
XXXXOOOOOXX
XXXOOOOOOXX
XXOOOFOOOXX
XXOOOOOOOOX
XXXXXOOXOOX