OOOOOOOOOOO
OOOOOOOOOOO
OOOOOOOOOOO
OOOOOOOOOOO
OOOOOOOOOOO
XXXXXXXXXXX
XXXXPXXXFXX
OOOOOXOOOXX
XXXOOXOXXOO
OXOOOOOOOOO